1111111111111111111111111111111111111111
1000000000000000000000000000000000000001
1000000011111111111111111111111111111111
1000000000000000000000000000000000000001
1000000011111111111111111111111111111111
1000000000000000000000000000000000000001
1000000011111111111111111111111111111111
1000000000000000000000000000000000000001
1000000011111111111111111111111111111111
1000000000000000000000000000000000000001
1000000011111111111111111111111111111111
1000000000000000000000000000000000000001
1000000011111111111111111111111111111111
1000000000000000000000000000000000000001
1000000011111111111111111111111111111111
1000000000000000000000000000000000000001
1000000011111111111111111111111111111111
1000000000000000000000000000000000000001
1000000011111111111111111111111111111111
1000000000000000000000000000000000000001
1000000011111111111111111111111111111111
1000000000000000000000000000000000000001
1000000011111111111111111111111111111111
1000000000000000000000000000000000000001
1000000011111111111111111111111111111111
1000000000000000000000000000000000000001
1000000011111111111111111111111111111111
1000000000000000000000000000000000000001
1000000011111111111111111111111111111111
1000000000000000000000000000000000000001
1000000011111111111111111111111111111111
1000000000000000000000000000000000000001
1000000011111111111111111111111111111111
1000000000000000000000000000000000000001
1000000011111111111111111111111111111111
1000000000000000000000000000000000000001
1000000011111111111111111111111111111111
1000000000000000000000000000000000000001
1000000011111111111111111111111111111111
1111111111111111111111111111111111111111
