1111111111111111111111111111111111111111
1000000000000000000000000000000000000001
1011111111111111111111111111111111100001
1010000000000000000001000000000000000001
1010000000000000000001000001111111111111
1010000000000000000001000000000000000001
1011111111111110000001000000000000000001
1010000000000000000001000000000000000001
1010000000000000000001000000000000000001
1010000000000000000001000000000000000001
1010000000000000000001000000000000000001
1010000000000000000001000000000000000001
1010000000000000000001111111111110000001
1010000000000000000001000000000010000001
1010000000000000000001000000000010000001
1011111111111111111111000000000000000001
1000000010000000000001000000000000000001
1000000010000000000001000000000000000001
1000000010000000000001000000000000000001
1000000010000001000001000000000010000001
1000000010000001000001000000000010000001
1000000010000001000000000000000010000001
1000000010000001000000000000000011100111
1000000010000000000000000000000010000001
1000000000000000000001000000000010000001
1000000000000000000001000000000010000001
1000011111111111000001000000000010000001
1000000000000000000001000000000000000001
1000000000000000000001000000000000000001
1111111111111111111111111111111000000001
1000000000000000000000000000001000000001
1000000000000000000000000000001111110001
1000000000000000000000000000001000000001
1000001111111111111111111111111000000001
1000001000000000000000000000000000000001
1000001000000000000000000000000000000001
1000001000000000000000111111111111111111
1000000000000000000000000000000000000001
1000000000000000000000000000000000000001
1111111111111111111111111111111111111111
